11111111
1XXXX1P1
1PXXX111               
LXXXXXX1
1XXXXXX1
11111111
11111111
11111111