111111111111
1P0C000000E1
10BC11C10B01
111111100C11
10C0000C1CB1
111111111111
