111111111111
1PC0000000E1
100010010111
111111111111