1111111111111111111111111111
1000000011110000000111100001
101111001B000B011B000B001111
1000000011111100001111100001
101110000C00000000C000011101
100011110B01110110B011110001
1000000000000000000000000001
11110001111B000B111100011111
1000000000111111100000000001
1011100111000000011100111011
1000000000C0000C000000000001
101111001111P011111001111101
10000000000000000000000000E1
1111111111111111111111111111
