111111111111
1P0C00000CE1
10BC11C10001
111111100C11
10C0000C1CB1
111111111111
