1111111111111111111111111111111111111111
111111111P0000000000100000000000000110E1
10000000010111111111111111111111111100C1
1111111000000000000000000000000000000001
1000000000000111111111111111110000000001
1111111111111111111111111111111111111111
