1111111111111111111111111111
1C0000001111000C0001111000C1
101111001BC00B011B000B001111
1000000011111100001111100001
1C1110000C00000000C000011101
100011110B01110110B011110001
10000000000000000000000000C1
11110001111B0C0B111100011111
10000000001111111000000000C1
1011100111000000011100111011
1C00000000C0000C000000000001
101111001111P011111001111101
1B0000001B0000000000000000E1
1111111111111111111111111111
