111111
1P01C1
101111
1C00E1
111111
