111111111
1P00C0001
101110101
1C0010E01
101110101
10000C001
111111111