1111111111
1P00000C01
1011101111
1010101B01
1010101E01
1CB0000001
1111111111