1111111111111111
1P00000C00000001
1011111101111111
1C00000000B00001
1111100111111101
100010010001C101
1010100101B00001
10E0000000000001
1111111111111111
