111111111111111111111111111
1P000000C0000000000001C0001
1001101110111011100001B1011
100010001000100C10C00000001
100010011001100010000000001
1000100C1000100010001000111
10001011101110001B0010001E1
1C000000C0000000000C1000001
111111111111111111111111111